{
  "level_name": "The Quad",
  "initial_fuel": 75,
  "hint_battery": 1,
  "map_grid": [
    "WWWWWWWWWWW1WWWWWWWWWWWW",
    "W111W11111111111111W111W",
    "W1S1W1WWWWW1WWWWW1W1W11W",
    "W11111WWWWW1WWWWW1W111DW",
    "WWWWWWWWWWW1WWWWWWWWWWWW",
    "W11111WWWWW1WWWWW111111W",
    "W1W1W1WWWWW1WWWWW1W1W11W",
    "W1W1W11111111111111W1W1W",
    "111W1WWWWWWWWWWWWW1W1W11",
    "W1W1W1WWWWWWWWWWWWW1W1W1",
    "W1W1W1W1111111111111D11W",
    "WWWWWWWWWW1WWWWWWWWWWWWW",
    "W111D1W1111WWWW11111111W",
    "W11111W1WWWWWWW1W1WWWWWW",
    "W11111W111111111W111111W",
    "WWWWWWWWWWWWWWWWWWWWWWWW"
  ]
}