{
  "level_name": "Dual Peaks",
  "initial_fuel": 90,
  "hint_battery": 2,
  "map_grid": [
    "WWWWWWWWWWWWWWWWWWWWWWWW",
    "WS1111WWWWWWWWWW1111111W",
    "WWWW111WWWWWWWWW111WWW1W",
    "WWW111WWWW33333WWWW111DW",
    "WW11122223333322221111WW",
    "W111WWWWW33333WWWWW1111W",
    "W11WWWWWW11111WWWWWW1WWW",
    "W1111111111111111111111W",
    "W11WWWWWW11111WWWWWW1WWW",
    "W111WWWWW33333WWWWW1111W",
    "WW11122223333322221111WW",
    "WWW111WWWW33333WWWW1D1WW",
    "WWWW111WWWWWWWWW111WWWWW",
    "WD1111WWWWWWWWWW1111111W",
    "WWWWWWWWWWWWWWWWWWWWWWWW",
    "WWWWWWWWWWWWWWWWWWWWWWWW"
  ]
}