{
  "level_name": "Serpentine Pass",
  "initial_fuel": 65,
  "hint_battery": 1,
  "map_grid": [
    "WWWWWWWWWWWWWWWWWWWWWWWW",
    "WSD111111111111111223WWW",
    "WWWWWWWWWWWWWWWWWW123WWW",
    "W1111111111111111112WWWW",
    "W1WWWWWWWWWWWWWWWWW2WWWW",
    "W1211111111111111111111W",
    "W1W1WWWWWWWWWWWWWWWW3W1W",
    "W131WWWWWWWWWWWWWWWW1W1W",
    "W133WWWWWWWWWWWWWWW131DW",
    "W1111111111111111112121W",
    "WWWWWWWWWWWWWWWW1W1W1W1W",
    "WWWWWWWWWWWWWWWW1W1W1W1W",
    "W1111111111111111W1W1W1W",
    "W1WWWWWWWWWWWWWWW1W1W1WW",
    "W1D11111111111111111111W",
    "WWWWWWWWWWWWWWWWWWWWWWWW"
  ]
}