{
  "level_name": "Industrial Loop",
  "initial_fuel": 70,
  "hint_battery": 3,
  "map_grid": [
    "WWWWWWWWWWWWWWWWWWWWWWWW",
    "W1111111111111111111111W",
    "W1S1W2W1W1111111W1W2W11W",
    "W1W1W2W1W1WW1WW1W1W2W11W",
    "W1W1W2W1W1W111W1W1W2W11W",
    "W1W1W2W1W1W1D1W1W1W2W11W",
    "W1W1W2W1W1W111W1W1W2W11W",
    "W1W1W2W1W1WWWWW1W1W2W11W",
    "W1111111111111111111111W",
    "W1W1W2W1W1WWWWW1W1W2W11W",
    "W1W1W2W1W1W111W1W1W2W11W",
    "W1D1W2W1W1W111W1W1W2W1DW",
    "W1W1W2W1W1W111W1W1W2W11W",
    "W1W1W2W1W1WWWWW1W1W2W11W",
    "W1111111111111111111111W",
    "WWWWWWWWWWWWWWWWWWWWWWWW"
  ]
}