{
  "level_name": "The Maze",
  "initial_fuel": 85,
  "hint_battery": 3,
  "map_grid": [
    "WWWWWWWWWWWWWWWWWWWWWWWW",
    "WS11W111W1111W111W1111DW",
    "WW1WW1W1W1W11W1W1W1W1W1W",
    "W111W1W111W1111W1W111W1W",
    "W1W1W1WWWWW1WWWWWWW1W11W",
    "W1W111111111W1111111W31W",
    "W1WWWWWWWWWWW1W222W1W11W",
    "W1111111111111W111W1W11W",
    "WWWWWWWWW1WWWWWW1W1W1W1W",
    "W1111111W1W11111W131D11W",
    "W1WWWWWWW131313131W1WWWW",
    "W1W11111131313131W11111W",
    "W1W1WWWWW131313131WWWWWW",
    "WD11W1111W111W111111111W",
    "WWWWWWWWWWWWWWWWWWWWWWWW",
    "WWWWWWWWWWWWWWWWWWWWWWWW"
  ]
}