{
  "level_name": "Flooded City",
  "initial_fuel": 95,
  "hint_battery": 1,
  "map_grid": [
    "WWWWWWWWWWWWWWWWWWWWWWWW",
    "WS11WWWWWWWWWWWW111111DW",
    "WW1WWWWWWWWWWWWW1WWWWWWW",
    "WW121W1111WWWWWW1W121WWW",
    "WWWWWW1WW1WWWWWW1W1WW1WW",
    "W111111WW11111111W1WW1WW",
    "W1WWWWWWWWWWWWWWWW1WW1DW",
    "W1WWWWWWWWWWWWWWWW1211WW",
    "W1WW1111111WWWWWWW1WWWWW",
    "W1WW1WWWW1WWWWWWWW1WWWWW",
    "WD121W1WW1111WWWWW11111W",
    "WWWWWW1WWWW3WWWWWWWW1WWW",
    "WWWWWW11111WWWWWWWWWW1WW",
    "WWWWWWWWWWWWWWWWWWWWWW1W",
    "WWWWWWWWWWWWWWWWWWWWWW1W",
    "WWWWWWWWWWWWWWWWWWWWWWWW"
  ]
}