{
  "level_name": "The Quad",
  "initial_fuel": 90,
  "hint_battery": 2,
  "map_grid": [
    "WWWWWWWWWWW1WWWWWWWWWWWW",
    "W111W11111111111111W111W",
    "W1S1W1WWWWW1WWWWW1W1W11W",
    "W11111WWWWW1WWWWW1W111DW",
    "WWWWWWWWWWW1WWWWWWW22WWW",
    "W11111WWWWW1WWWWW111111W",
    "W1W1W1WWWWW1WWWWW1W1W11W",
    "W1W1W1111111111111121W1W",
    "111W1WWWWWWWWWWWWW121W11",
    "W1W1W1WWWWWWWWWWWWW121W1",
    "W1W1W1W1111111111111D11W",
    "WWWWWWWWWW12222WWWWWWWWW",
    "W111D133333WWWW11111111W",
    "W11111W1WWWWWWW1W1WWWWWW",
    "W11111W111111111W111111W",
    "WWWWWWWWWWWWWWWWWWWWWWWW"
  ]
}