{
  "level_name": "Core Meltdown",
  "initial_fuel": 60,
  "hint_battery": 0,
  "map_grid": [
    "WWWWWWWWWWWWWWWWWWWWWWWW",
    "WW11111111111111111111WW",
    "WW1S11222222222222211D1W",
    "WW11233333333333333211WW",
    "WW12333333333333333321WW",
    "WW12333WWWWWWWWWW333321W",
    "WW1233WW11111111WW33321W",
    "WW123WW11D111111WW3332DW",
    "WW1233WW11111111WW33321W",
    "WW12333WWWWWWWWWW333321W",
    "WW12333333333333333321WW",
    "WW11233333333333333211WW",
    "WW1D122222222222222111WW",
    "WW11111111111111111111WW",
    "WWWWWWWWWWWWWWWWWWWWWWWW",
    "WWWWWWWWWWWWWWWWWWWWWWWW"
  ]
}